Testmap Begins 
Jiisuki
64
32
12
2
 8  8  8  8  8  8  8  8  8  8  8  8  8  8  8  8  1  2  2  2  2  2  2  2  2  2  2  2  2  2  2  2 
 2  2 49  8  8  8  1  2  2  2  2  2  2  2  2  2  2  2  2  2  2  2  2  2  2  3  8  8  8  8  8  8 
 8  8  8  8  8  8  8  8  8  8  8  8  8  8  8  8  4  0  0  0  0  0  0  0  0 47 32  8  8  8  8  8 
 8  8 48 49  8  8  4  0  0  0  0  0  0  0  0  0  0  0  0  0  0  0  0  0  0  5  8  8  8  8  8  8 
 1  2  2  2  2  2  2  2  2  2  2  2  2  2  2  2 12  0  0  0  0  0  0  0  0 47 33  8  8  8  8  8 
 8  8  8 48  2  2 12  0  0  0  0  0  0  0  0  0  0  0  0  0  0  0  0  0  0  5  8  8  8  8  8  8 
 4  0  0  0 47  8  8  8  8  8  8  8  8  8  8  8 46  0  0  0  0  0  0  0  0 47 33  8  8  8  8  8 
 8  8  8  8  8  8 46  0  0  0  0  0  0  0  0  0  0  0  0  0  0  0  0  0  0  5  8  8  8  8  8  8 
 4  0  0  0 47  8  8  8  8  8  8  8  8  8  8  8 46  0  0  0  0  0  0  0  0 47 34  8  8  8  8  8 
 8  8  8  8  8  8 46  0  0  0  0  0  0  0  0  0  0  0  0  0  0  0  0  0  0 13  2  2  2  2  2  3 
 4  0  0  0 47  8 60 61 61 61 61 61 61 61 62  8 46  0  0  0  0  0  0 24 25 20  9 10  8  8  8  8 
 8  8  8  8  8  8 46  0  8  8  8  8  8  0  0  0  0  0  0  0  0  0  0  0  0  0  0  0  0  0  0  5 
 4  0  0  0 47  8  8  8  8  8  8  8  8  8  8  8 46  0  0  0  0  0  0  0  0 13  2 12  8  8  8  8 
 8  8  8  8  8 11 16 28 29  0  0  0  0  0  0  0  8  8  8  8  8  0  0  0  0  0  0  0  0  0  0  5 
 4  0  0  0 11  9  9  9  9  9 10  8  8  8  8  8 46  0  0  0  0  0  0  0  0 47 32  8  8  8  8  8 
 8  8  8  8  8  5  4  0  0  0  0  0  0  0  0  0  0  0  0  0  0  0  0 24 19 20  9  9 10  0  0  5 
 4  0  0  0  5  8  8  8  8  8  4  8  8 35  8 37 46  0  0  0  0  0  0  0  0 47 33  8  8  8  8  8 
 8  8  8  8  8 13 12  0  8  0  0  0  0  0  0  0  8  8  8  0  0  8  8  8  8  5  8  8  4  0  0  5 
 4  0  0  0  5  8  8  8  8  8  6  9  9 14 61 15  9  9 10  0  0  0  0  0  0 47 33  8  8  8  8  8 
 8  8  8  8  8  8 46  0  0  0  0  0  8  0  0  0  0  0  0  0  0  0  0  0  0  5  8  8  4  0  0  5 
 4  0  0  0  5  8  8  8  8  8  8  8  8  4 61  5  8  8  4  0  0  0  0  0  0 47 34  8  8  8  8  8 
 8  8  8  8  8  8 46  0  0  0  0  0  0  0  0  0  0  0  0  0  0  0  0  0  0  5  8  8  4  0  0  5 
 4  0  0  0  5  8  8  8  8  8  8  8  8  4 36  5  8  8  4  0  0  0  0 38  9  9  9 39  8  8  8  8 
11  9  9  9  9  9  9  9  9  9 10  0  0  0  0  0  0  0  0  0  0  0  0  0  0  5  8  8  4  0  0  5 
 4  0  0  0  5  8  8  8  8  8  8  8  8  6  9  7  8  8  4  0  0  0  0 47 32  8 32  8  8  8  8  8 
 5  1  2  2  2  2  2  2  2  3  4  0  0  0  0  0  0  0  0  0  0  0  0  0  0  5  8  8  4  0  0  5 
 4  0  0  0 13  2  2  2  2  2  2  2  2  2  2  2  2  2 12  0  0  0  0 47 33  8 33  8  8  8  8  8 
 5  4 56 57 58 58 58 58 59  5  4  0  0  0  0 35  0 37  0  0  0  0  0  0 11  7  8  8  4  0  0  5 
 4  0  0  0  0  0  0  0 47  8  8  8 32  8  8  8 32 46  0  0  0  0  0 47 33  8 33  8  8  8  8  8 
13 12  8  8  8  8  8  8  8 13 12  0  0 11  9 14 36 15  9  9 10  0  0  0  5  8  8  8  4  0  0  5 
 4  0  0  0  0  0  0  0 47  8  8  8 33  8  8  8 33 46  0  0  0  0  0 47 33  8 33  8  8  8  8  8 
 8  8  8  8  8  8  8  8  8  8 46  0  0  5  8  6  9  7  8  8  4  0  0  0  5  8  8  8  4  0  0  5 
 4  0  0  0  0  0  0  0 47 60 61 62 33  8  8  8 33 46  0  0  0  0  0 47 34  8 34  8  8  8  8  8 
 8  8  8  8  8  8  8  8  8  8 46  0  0  5  8  8  8  8  8  8  4  0  0  0  5  8  8  8  4  0  0  5 
 4  0  0  0  0  0  0  0 47  8  8  8 33  8  8  8 33 46  0  0  0  0  0 38  9  9  9 39  8  8  8  8 
 8  8  8  8  8  8  8  8  8 11  9  9  9  7  8  8  8  8  8  8  4  0  0  0 13  2  2  2 12  0  0  5 
 4  0  0  0  0  0  0  0 47 60 61 62 33  8  8  8 33 46  0  0  0  0  0 47 32  8 32  8  8  8  8  8 
 8 38  9  9 39  8  8  8  8 13  2  2  2  2  2  2  2 49  8  8  4  0  0  0  8  0  0  0  0  0  0  5 
 4  0  0  0  0  0  0  0 47  8  8  8 33  8  8  8 33 46  0  0  0  0  0 47 33  8 33  8  8  8  8  8 
 8  8  8  8  8  8  8  8  8  8  8  8 32  8 46  0  0 53 49  8  4  0 37  0  8  0  0  0  0  0  0  5 
 4  0  0  0  0  0  0  0 47 35  8 37 34  8  8  8 34 46  0  0  0  0  0 47 33  8 33  8  8  8  8  8 
 8  8  8  8  8  8  8  8  8  8  8  8 33  8 46  0  0  8  5  8  4 36 15  9  9  9  9  9 10  0  0  5 
 4  8  0 11  9  9  9  9  9 14 36 15  9  9  9  9  9  9  9 10  0  0  0 47 33  8 33  8  8  8  8  8 
 8  8  8  8  8  8  8  8 35  8 37  8 34  8 46  0  8  8  5  8  6  9  7  8  8  8  8  8  4  0  0  5 
 4  8  0  5  8  8  8  8  8  6  9  7  8  8  8  8  8  8  8  4  0  0  0 47 33  8 33  8  8  8  8  8 
 8  8  8  8 11  9  9  9 14  8 15  9  9  9  9 40  8  8 13  2  2  2  2  2  2  2  2  2 12  0  0  5 
 4  8  0  5  8 50  2  2  2  2  2  2  2  2  2  2 49  8  8  4  0  0  0 47 33  8 33  8 38  9  9 39 
 8  8  8  8  5  8  8 50 12  8 13 49  8  8  8 42 40  8  8  8  0  0  0  0  0  0  0  0  0  0  0  5 
 4  8  0  5 50 51  8  8  8  8  8  8  8  8  8  8 48 49  8  4  0  0  0 47 33  8 33  8  8  8  8  8 
 8  8  8  8 13  2  2 51  0  0  0 48  2  2  2 49 42  9 10  0  0  0  0  0  0  0  0  0  0  0  0  5 
 4  8  0  5  4  8 60 61 61 61 61 61 61 61 61 62  8  5  8  4  0  0  0 47 33  8 33  8  8  8  8  8 
 8  8  8  8 32  8 46  0  0  0  0  0  0  0  0 48 49  8  4  0  0  0  0 38  9 39  0  0  0  0  0  5 
 4  8  0 13 12  8  8  8  8  8 55 55 55  8  8  8  8  5  8  4  0  0  0 47 33  8 33  8  8  8  8  8 
 8  8  8  8 33  8 46  0  0  0  0  0  0  0  0  0 48  2 12  0  0  0  0  0  0  0  0  0  0  0  0  5 
 4  0  0  8 47  8 60 61 62  8 11  9 10  8 60 62  8 13  2 12  0  0  0 47 34  8 34  8  8  8  8  8 
35  8 37  8 34  8 46  0 45  9 40  0  0  0  0  0  0  0  0  0  0  0  0  0  0  0  0  0  0  0  0  5 
 4  0  0  0 47  8  8  8  8  8  5  8  4  8  8  8  8  8  8 46  0  0  0 11  9  9  9  9  9  9  9  9 
14 36 15  9  9  9  9  9 43  8 42 40  0  0  0  0  0  0  0  0  0  0  0  0  0  0  0  0  0  0  0  5 
 4  0 37  0 47  8 60 61 62  8  5  8  4  8 60 61 62  8  8 46  0  0  0  5  8  8  8  8  8  8  8  8 
 4 36  5  8  8  8  8  8  8  8  8 42 40  8  8  0  0  0  0  0  0  0  0  0  8  8  8  8  8  8  8  5 
 4 36 15  9 10 55 55 55 55 55  5  8  4 55 55 55 55 55 55 11  9  9  9  7  8  8  8  8  8  8  8  8 
 4 36  5  8  8  8  8  8  8  8  8  8 42  9  9 16 17 18 18 18 18 18 19 20  9  9  9  9  9  9  9  7 
 6  9  7  8  6  9  9  9  9  9  7  8  6  9  9  9  9  9  9  7  8  8  8  8  8  8  8  8  8  8  8  8 
 6  9  7  8  8  8  8  8  8  8  8  8  8  8  8  4  0  0  0  0  0  0  0  5  8  8  8  8  8  8  8  8 
ARMOR
1312 832 25 1
HEALTH
1792 384 25 1
SPAWN
1696 640 25 1
TRAILGUN
96 896 25 1
SPAWN
1056 960 25 1
SPAWN
320 672 25 1
ARMOR
832 512 25 1
SLUGS
160 192 25 1
SPAWN
448 352 25 1
SPAWN
1536 416 25 1
BATTERY
1856 192 25 1
HEALTH
448 640 25 1
SLUGS
1088 320 25 1
TRAILGUN
1056 320 25 1
RAILGUN
1152 672 25 1
RAILGUN
1824 192 25 1
BATTERY
1120 544 25 1
SPAWN
32 960 25 1
SLUGS
192 192 25 1
SENSOR
1792 768 25 1
HEALTH
1376 672 25 1
HEALTH
1440 672 25 1
CAP
160 480 25 1
SLUGS
736 128 25 1
SLUGS
768 128 25 1
GRENADES
1376 512 25 1
GRENADES
1408 512 25 1
GRENADES
1280 160 25 1
HEALTH
960 704 25 1
HEALTH
928 704 25 1
HEALTH
992 704 25 1
HEALTH
896 704 25 1
GRENADES
1440 928 25 1
BATTERY
1088 544 25 1
ARMOR
800 512 25 1
ARMOR
768 512 25 1
