ENTERING
JIISUKI
STORY\STORY02.bmp
99
2
64
64
     11111111111111                    111111111111111111       
     11111111111111                    11111111111      1       
     11111111111111                    11111111111    g 1       
     11111111111111                    11111111111  11111       
     11111111111111                    11       11  11111       
     11111111111111                    11  1111 11 111111       
     11111111111111                       11111    111111       
     111          1                    111111111111111111       
  h s                                  111111111111111111       
  111111          111111111111111111111111111111111111111       
     111                                              111       
     111                                              111       
     111                                              111       
     111                                              111       
     111                                              111       
     111                                              111       
     111                                              111       
     111                                              111       
     111                                              111       
     111                                              111       
     111                                              111       
     111                                              111       
     111                                              111       
     111                                              111       
     111                                              111       
     111                                              111       
     111 11111    11                                  111       
     111  Z1^    111                                  111       
     1111111^   1111                                  111       
     111   1^1111111                                  111       
     111   1^1111111                                  111       
            ^                                         111       
            ^                                         111       
  1111111  11111111                                   111       
 11111111  1                                          111       
111111111  1                                          111       
111111111                                             111       
111111111                                             111       
111111111                                             111       
111111111                                             111       
111111111                                             111       
111111111                                             111       
111111111                                             111       
111111111                                             111       
111111111                                             111       
111111111                                             111       
111111111                                             111       
111111111                                             111       
111111111                                             111       
111111111                                             111       
111111111                                             111       
111111111                                             111       
111111111                                             111       
111111111                                             111       
111111111                                             111       
111111111                                             111       
111111111                                             111       
111111111                                             111       
111111111                                            1111       
1111111Z                                             1111       
1111111111111111111111111111111111111111111111111               
11111111111111111111111111111111111111111111111111              
1111111111111111111111111111111111111111111111111111111111111111
1111111111111111111111111111111111111111111111111111111111111111
