Custom 01
Jiisuki
32
32
4
2
0
 1  2  2  2  2  2  2  2  2  2  2  2  2  3  8  8  8  8  1  2  2  2  2  2  2  2  2  2  2  2  2  3 
 4  0  0  0 47 32  8  8 32 46  0  0  0  5  8  8  8  8  4  0  0  0 47 32  8  8 32 46  0  0  0  5 
 4  0  0  0 47 33  8  8 33 46  0  0  0  5  8  8  8  8  4  0  0  0 47 33  8  8 33 46  0  0  0  5 
 4  0  0  0 47 34  8  8 34 46  0  0  0  5  8  8  8  8  4  0  0  0 47 34  8  8 34 46  0  0  0  5 
 4  0  0  0 38  9  9  9  9 39  0  0  0 13  2  2  2  2 12  0  0  0 38  9  9  9  9 39  0  0  0  5 
 4  0  0  0  0  0  0  0  0  0  0  0  0  0  0  0  0  0  0  0  0  0  0  0  0  0  0  0  0  0  0  5 
 4  0  0  0  0  0  0  0  0  0  0  0  0  0  0  0  0  0  0  0  0  0  0  0  0  0  0  0  0  0  0  5 
 4  0  0  0  0  0  0  0  0  0  0  0  0  0  0  0  0  0  0  0  0  0  0  0  0  0  0  0  0  0  0  5 
 6  9  9 10  0  0  0  0  0  0 11  9  9  9 10  0  0 11  9  9  9 10  0  0  0  0  0  0 11  9  9  7 
 1  2  2 12  0  0  0  0  0  0 13  2  2  3  4  0  0  5  1  2  2 12  0  0  0  0  0  0 13  2  2  3 
 4  0  0  0  0  0  0  0  0  0  0  0  0  5  4  0  0  5  4  0  0  0  0  0  0  0  0  0  0  0  0  5 
 4  0  0  0  0  0  0  0  0  0  0  0  0  5  4  0  0  5  4  0  0  0  0  0  0  0  0  0  0  0  0  5 
 4  0  0  0  0  0  0  0  0  0  0 35  0  5  4  0  0  5  4  0 37  0  0  0  0  0  0  0  0  0  0  5 
 4  0  0  0 11  9  9  9  9  9  9 14 36  5  4  0  0  5  4 36 15  9  9  9  9  9  9 10  0  0  0  5 
 4  0  0  0 13  2  2  2  2  2  3  4 36  5  4  0  0  5  4 36  5  1  2  2  2  2  2 12  0  0  0  5 
 4  0  0  0 47 32 46  0  0  0  5  4 36 13 12  0  0 13 12 36  5  4  0  0  0 47 32 46  0  0  0  5 
 4  0  0  0 47 33 46  0  0  0  5  4 36  8 46  0  0 47  8 36  5  4  0  0  0 47 33 46  0  0  0  5 
 4  0  0  0 47 34 46  0  0  0  5  4 36  8 46  0  0 47  8 36  5  4  0  0  0 47 34 46  0  0  0  5 
 6  9  9  9  9  9  9 10  0  0  5  4 36 11 10  0  0 11 10 36  5  4  0  0 11  9  9  9  9  9  9  7 
 8  8  8  8  8  8  8  4  0  0  5  4 36  5  4  0  0  5  4 36  5  4  0  0  5  8  8  8  8  8  8  8 
 1  2  2  2  2  2  2 52  0  0  5  4 36  5  4  0  0  5  4 36  5  4  0  0 53  2  2  2  2  2  2  3 
 4  0  0  0  0  0  0  0  0  0  5  4 36  5  4  0  0  5  4 36  5  4  0  0  0  0  0  0  0  0  0  5 
 4  0  0  0  0  0  0  0  0  0  5  4 36  5  4  0  0  5  4 36  5  4  0  0  0  0  0  0  0  0  0  5 
 4  0  0  0  0  0  0  0 45  9  7  6  9  7  4  0  0  5  6  9  7  6  9 40  0  0  0  0  0  0  0  5 
 4  0  0  0  0  0 11  9 43  8  8  8 50  2 12  0  0 13  2 49  8  8  8 42  9 10  0  0  0  0  0  5 
 4  0  0  0  0  0 13  2  2  2  2  2 51 32 46  0  0 47 32 48  2  2  2  2  2 12  0  0  0  0  0  5 
 4  0  0  0  0  0  0 47  8  8  8  8  8 33 46  0  0 47 33  8  8  8  8  8 46  0  0  0  0  0  0  5 
 4  0  0  0  0  0  0 47  8  8  8  8  8 34 46  0  0 47 34  8  8  8  8  8 46  0  0  0  0  0  0  5 
 4  0  0  0  0  0  0 47  8  8  8  8 44  9  9  9  9  9  9 41  8  8  8  8 46  0  0  0  0  0  0  5 
 4  0  0  0  0  0  0 47  8  8  8 44 43  8  8  8  8  8  8 42 41  8  8  8 46  0  0  0  0  0  0  5 
 4  0  0  0  0  0  0 47  8  8 44 43  8  8  8  8  8  8  8  8 42 41  8  8 46  0  0  0  0  0  0  5 
 6  9  9  9  9  9  9  9  9  9 43  8  8  8  8  8  8  8  8  8  8 42  9  9  9  9  9  9  9  9  9  7 
RAILGUN
192 96 25 1
SPAWN
384 704 25 1
SPAWN
608 704 25 1
BATTERY
224 96 25 1
SLUGS
768 96 25 1
TRAILGUN
800 96 25 1
HEALTH
288 704 25 1
ARMOR
448 864 25 1
ARMOR
480 864 25 1
ARMOR
512 864 25 1
ARMOR
544 864 25 1
LAUNCHER
288 384 25 1
LAUNCHER
704 384 25 1
GRENADES
224 384 25 1
GRENADES
160 384 25 1
GRENADES
192 384 25 1
GRENADES
768 384 25 1
GRENADES
800 384 25 1
GRENADES
832 384 25 1
HEALTH
192 736 25 1
HEALTH
800 736 25 1
