Weapon Factory 
Jiisuki
32
32
4
2
1
 1  2  2  2  2  2  2  2  2  2  2  2  2  2  2  3  1  2  2  2  2  2  2  2  2  2  2  2  2  2  2  3 
 4  0  0  0  0 47 32  8  8 32 46  0  0  0  0  5  4  0  0  0  0 47 32  8  8 32 46  0  0  0  0  5 
 4  0  0  0  0 47 33  8  8 33 46  0  0  0  0  5  4  0  0  0  0 47 33  8  8 33 46  0  0  0  0  5 
 4  0  0  0  0 47 33  8  8 33 46  0  0  0  0  5  4  0  0  0  0 47 33  8  8 33 46  0  0  0  0  5 
 4  0  0  0  0 47 34  8  8 34 46  0  0  0  0  5  4  0  0  0  0 47 34  8  8 34 46  0  0  0  0  5 
 4  0  0  0  0 38  9  9  9  9 39  0  0  0  0  5  4  0  0  0  0 38  9  9  9  9 39  0  0  0  0  5 
 4  0  0  0  0  0  0  0  0  0  0  0  0  0  0 13 12  0  0  0  0  0  0  0  0  0  0  0  0  0  0  5 
 4  0  0  0  0  0  0  0  0  0  0  0  0  0  0  0  0  0  0  0  0  0  0  0  0  0  0  0  0  0  0  5 
 4  0  0  0  0  0  0  0  0  0  0  0  0  0  0 11 10  0  0  0  0  0  0  0  0  0  0  0  0  0  0  5 
 4  0  0  0  0  0  0  0  0  0  0  0  0  0  0  5  4  0  0  0  0  0  0  0  0  0  0  0  0  0  0  5 
 4  0  0  0  0  0  0  0  0  0  0  0  0  0  0  5  4  0  0  0  0  0  0  0  0  0  0  0  0  0  0  5 
 4  0  0  0  0  0  0  0  0  0  0  0  0  0  0  5  4  0  0  0  0  0  0  0  0  0  0  0  0  0  0  5 
 4  0  0  0  0  0  0  0  0  0  0  0 35  0 37  5  4 35  0 37  0  0  0  0  0  0  0  0  0  0  0  5 
 4  0  0 38  9  9 39  0  0 11  9  9 14 36 15  7  6 14 36 15  9  9 10  0  0 38  9  9 39  0  0  5 
 4  0  0  0 47 32 46  0  0  5  8  8  4 36  5  8  8  4 36  5  8  8  4  0  0 47 32 46  0  0  0  5 
 4  0  0  0 47 33 46  0  0 13  2  3  4 36  5  8  8  4 36  5  1  2 12  0  0 47 33 46  0  0  0  5 
 4  0  0  0 47 33 46  0  0  0  0  5  4 36  5  8  8  4 36  5  4  0  0  0  0 47 33 46  0  0  0  5 
 4  0  0  0 47 34 46  0  0  0  0  5  6  9  7  8  8  6  9  7  4  0  0  0  0 47 34 46  0  0  0  5 
 4  0  0  0 11  9  9  9 10  0  0  5  8  8  8  8  8  8  8  8  4  0  0 11  9  9  9 10  0  0  0  5 
 4  0  0  0  5  8  8  8  4  0  0 13  2  2  2  2  2  2  2  2 12  0  0  5  8  8  8  4  0  0  0  5 
 4  0  0  0  5  8  8 50 52  0  0 47 32  8  8  8  8  8  8 32 46  0  0 53 49  8  8  4  0  0  0  5 
 4  0  0  0 13  2  2 52  0  0  0 47 33 60 62  8  8 60 62 33 46  0  0  0 53  2  2 12  0  0  0  5 
 4  0  0  0  0  0  0  0  0  0  0 47 33  8  8 60 62  8  8 33 46  0  0  0  0  0  0  0  0  0  0  5 
 4  0  0  0  0  0  0  0  0  0  0 47 34  8  8  8  8  8  8 34 46  0  0  0  0  0  0  0  0  0  0  5 
 4  0  0  0  0  0  0  0  0  0 45  9  9  9  9  9  9  9  9  9  9 40  0  0  0  0  0  0  0  0  0  5 
 4  0  0  0  0  0  0  0  0 45 43  0  0 47 32  8  8 32 46  0  0 42 40  0  0  0  0  0  0  0  0  5 
 4  0  0  0  0  0 38  9  9 43  0  0  0 47 33  8  8 33 46  0  0  0 42  9  9 39  0  0  0  0  0  5 
 4  0  0  0  0  0  0  0  0  0  0  0  0 47 34  8  8 34 46  0  0  0  0  0  0  0  0  0  0  0  0  5 
 4  0  0  0  0  0  0  0  0  0  0  0 45  9  9  9  9  9  9 40  0  0  0  0  0  0  0  0  0  0  0  5 
 4  0  0  0  0  0  0  0  0  0  0 45 43  8  8  8  8  8  8 42 40  0  0  0  0  0  0  0  0  0  0  5 
 4  0  0  0  0  0  0  0  0  0 45 43  8  8  8  8  8  8  8  8 42 40  0  0  0  0  0  0  0  0  0  5 
 6  9  9  9  9  9  9  9  9  9 43  8  8  8  8  8  8  8  8  8  8 42  9  9  9  9  9  9  9  9  9  7 
SPAWN
416 512 25 1
SPAWN
576 512 25 1
ARMOR
448 704 25 1
ARMOR
480 672 25 1
ARMOR
512 672 25 1
ARMOR
544 704 25 1
TRAILGUN
128 384 25 1
SLUGS
160 384 25 1
SLUGS
832 384 25 1
TRAILGUN
864 384 25 1
HEALTH
224 128 25 1
HEALTH
256 128 25 1
HEALTH
736 128 25 1
HEALTH
768 128 25 1
RAILGUN
480 832 25 1
BATTERY
512 832 25 1
