Laboratory 
Jiisuki
32
32
3
2
1
 1  2  2  2  2  2  2  2  2  2  2  2  2  2  2  2  2  2  2  2  2  2  2  2  2  2  2  2  2  2  2  3 
 4  0  0  0  0  0  0  0 47 32  8  8  8  8 46  0  0 47  8  8  8  8 32 46  0  0  0  0  0  0  0  5 
 4  0  0  0  0  0  0  0 47 33  8  8  8  8 46  0  0 47  8  8  8  8 33 46  0  0  0  0  0  0  0  5 
 4  0  0  0  0  0  0  0 47 33  8 60 62  8 46  0  0 47  8 60 62  8 33 46  0  0  0  0  0  0  0  5 
 4  0  0  0  0  0  0  0 47 33  8  8  8  8 46  0  0 47  8  8  8  8 33 46  0  0  0  0  0  0  0  5 
 4  0  0  0  0  0  0  0 47 33  8 60 62  8 46  0  0 47  8 60 62  8 33 46  0  0  0  0  0  0  0  5 
 4  0  0  0  0  0  0  0 47 33  8  8  8 44 39  0  0 38 41  8  8  8 33 46  0  0  0  0  0  0  0  5 
 4  0  0  0  0  0  0  0 47 34 55 55 44 43  0  0  0  0 42 41 55 55 34 46  0  0  0  0  0  0  0  5 
 4  0  0  0  0  0  0  0 38  9  9  9 43  0  0  0  0  0  0 42  9  9  9 39  0  0  0  0  0  0  0  5 
 4  0  0  0  0  0  0  0 47 32 46  0  0  0  0  0  0  0  0  0  0 47 32 46  0  0  0  0  0  0  0  5 
 4  0  0  0  0  0  0  0 47 33 46  0  0  0  0  0  0  0  0  0  0 47 33 46  0  0  0  0  0  0  0  5 
 4  0 35  0  0  0 37  0 47 34 46  0  0  0  0  0  0  0  0  0  0 47 34 46  0 35  0  0  0 37  0  5 
 6  9 14  0  0  0 15  9  9  9  9  9  9 10  0  8  8  8 11  9  9  9  9  9  9 14  0  0  0 15  9  7 
 8  8  4  0  0  0  5  8  8  8  8 50  2 12  0  8  8  8 13  2 49  8  8  8  8  4  0  0  0  5  8  8 
 8  8  4  0  0  0  5  8  8  8 50 51  0  0  8  8  8  8  0  0 48 49  8  8  8  4  0  8  0  5  8  8 
 1  2 12  0  0  0 13  2  2  2 51  0  0  0  0  0  0  0  0  0  0 48  2  2  2 12  0  0  0 13  2  3 
 4  0  0  0  0  0  0 47 32 46  0  0  0  0  0  0  0  0  0  0  0  0 47 32 46  0  0  0  0  0  0  5 
 4  0  0  0  0  0  0 47 34 46  0  0  0  0  0  0  0  0  0  0  0  0 47 34 46  0  0  0  0  0  0  5 
 4  0  0  0  0  0 24 25 20  9  9  9 40  0  0  0  0  0  0 45  9  9  9 16 28 29  0  0  0  0  0  5 
 4  0  0  0  0  0  0  0  5  8  8  8 42 40 35  0  8 37 45 43  8  8  8  4  0  0  0  0  0  0  0  5 
 4  0  0  0  0  0  0  0  5  8  8  8  8 42 14  0  0 15 43  8  8  8  8  4  0  0  0  0  0  0  0  5 
 4  0  0  0  0  0  0  0  5  8  8  8  1  2 12  0  0 13  2  3  8  8  8  4  0  0  0  0  0  0  0  5 
 4  0  0  0  0  0  0  0 13 49  8  8  4 55 46  0  0 47 55  5  8  8 50 12  0  0  0  0  0  0  0  5 
 4  0  0  0  0  0  0  0  0 48 49  8  6  9 10  0  0 11  9  7  8 50 51  0  0  0  0  0  0  0  0  5 
 4  0  0 35  0 37  0  0  0  0 48 49  8  8  4  0  0  5  8  8 50 51  0  0  0  0 35  0 37  0  0  5 
 6  9  9 14 36 15  9 40  0  0  0 48  2  2 12  0  0 13  2  2 51  0  0  0 45  9 14 36 15  9  9  7 
 8  8  8  4 36  5  8 42 40  0  0  0 47 32 46  0  0 47 32 46  0  0  0 45 43  8  4 36  5  8  8  8 
 8  8  8  4 36  5  8  8 42 40  0  0 47 33 46  0  0 47 33 46  0  0 45 43  8  8  4 36  5  8  8  8 
 8  8  8  4 36  5  8  8  8 42 40  0 47 33 46  0  0 47 33 46  0 45 43  8  8  8  4 36  5  8  8  8 
 8  8  8  4 36  5  8  8  8  8 42 40 47 34 46  0  0 47 34 46 45 43  8  8  8  8  4 36  5  8  8  8 
 8  8  8  4 36  5  8  8  8  8  8 42  9  9  9  9  9  9  9  9 43  8  8  8  8  8  4 36  5  8  8  8 
 8  8  8  6  9  7  8  8  8  8  8  8  8  8  8  8  8  8  8  8  8  8  8  8  8  8  6  9  7  8  8  8 
ARMOR
448 512 25 1
HEALTH
480 896 25 1
BATTERY
320 224 25 1
ARMOR
544 512 25 1
HEALTH
960 352 25 1
SPAWN
864 960 25 1
SPAWN
128 960 25 1
HEALTH
512 896 25 1
HEALTH
32 352 25 1
SLUGS
672 224 25 1
TRAILGUN
352 224 25 1
RAILGUN
640 224 25 1
GRENADES
544 288 25 1
LAUNCHER
128 640 25 1
LAUNCHER
864 640 25 1
GRENADES
448 288 25 1
HEALTH
32 768 25 1
HEALTH
960 768 25 1
CAP
416 704 25 1
SHIELD
576 704 25 1
