Facing Total Death
Jiisuki
CTF1.bmp
1
0
64
32
                        111 111  1111111                        
                        1     1  1     1                        
                        1     1  1     1                        
                      111  l  1111  b  111                      
                      1h^ 111      111 ^h1                      
111111111111111111111111^111111  111111^111111111111111111111111
1         1            1^1    1  1    1^1            1         1
1         1            1^1    1  1    1^1            1         1
11111111111            1^1    1  1    1^1            11111111111
1         1            1^1    1  1    1^1            1         1
1    y    1             ^              ^             1    x    1
1  s111s  1           a ^              ^ a           1  S111S  1
1  11111  1     hah   11^              ^11   hah     1  11111  1
1  1ss  ss      111   1111            1111   111      SS  SS1  1
1  111  1111    1     11111          11111     1    1111  111  1
1 ss     g1     1                              1     1g     SS 1
1J111   111     1                              1     111   111J1
11111   11      1                              1      11   11111
1               1       ei            ie       1               1
1        j   1JJ1    a111111J1    1J111111a    1JJ1   j        1
1       111  1111   1111111111    1111111111   1111  111       1
1   11J1111  1                                    1  1111J11   1
1   1111111  1                                    1  1111111   1
1   1111111  1                                    1  1111111   1
1          ad1   1J11111      1111      11111J1   1da          1
1        11111   111        a111111a        111   11111        1
1   e        1             1111111111             1        e   1
11J111       1           h11111  11111h           1       111J11
1111111      1           111111  111111           1      1111111
11111111                1111111  1111111                11111111
111111111 k   11J11111111111111  11111111111111J11   k 111111111
1111111111111111111111111111111  1111111111111111111111111111111
