FLOW OF THE MOON
Jiisuki
DM1.bmp
2
0
64
32
1111111111111111111111111111111111111111111111111               
1                               111             1               
1                                b              1               
1                             1111111           1               
1                            111111111          1               
1       f   f            1111111111111111111    1               
1  Shh  1   1   a       111    ^^^         1    1               
1  1111       1111     1111    ^^^         1    1               
1    111  k  111fS    11111chh ^^^         1    1               
1    11111111111111111111111111^^^ hhhh    1    1               
1    11111111111111111111111111^^^111111   1    11111111        
1                              ^^^                     1        
1J1111                         ^^^                     1        
1111111                        ^^^           ee        1        
    11111                      ^^^          1111       1        
           e                   ^^^       h  1111       1        
           1                   ^^^      111            1        
              e              a ^^^ a    1111           1        
              1              1111111    111111111111   1        
                 e                                     111111111
                 111                                           1
                 1111        a                                 1
                 11111111  h   h          l             ee     1
                 11111111S                       1111 11111    1
                 11111111111   11               11111 11111    1
                 11111111111   111 eee      111111111g11111    1
                 11111111111   1111111111          11111111    1
                 11111111111                       Sdj11       1
                 11111111111                       11111       1
                 11111111111  1111                        11J111
                 1111111111111  11  11111   111111 hdddh  1111  
                 1111111111111  111111111      111111111111111  
