Garden
JIISUKI
DM2.bmp
2
0
32
32
11111111111111111111111111111111
1                              1
1              lb              1
1             1111             1
1            111111            1
1            111111          111
1 fff        ae11ea           Z1
1 111       11111111       11111
1                              1
1                              1
1      1J1            1J1      1
1      111            111      1
1      111111111111111111     11
1      111111111111111111      1
1    1111111111111111111111    1
1    11111111111111111111111   1
1    1111111 ^ 1111111111111   1
111          ^                 1
1Z           ^              1111
1111111      ^           1111111
1j    1      ^           1    11
11    1      ^           1   iZ1
 1dd  11     ^           1   111
 1111        ^     g     1   1 1
 1  1S   k   ^        S  1  11 1
11  11111111 ^ 111111111 1S    1
1            ^  1111111  11    1
1   S        ^  1111111  1   ee1
1   1111111  ^           1  1111
1l  11111111 ^           1  1111
11  111111111^ h   h h h   11111
    1111111111111111111111111111
