X-Contra
Jiisuki
DM3.bmp
2
0
32 
45 
11111111111111111111111111111111
1                              1
1                              1
1                              1
1^^                            1
1^^111111111                   1
1^^1                           1
1^^1          111111       11111
1^^1  111111111s           1   1
1^^1  1       1            1   1
1^^1  1LLLLLLL1            1   1
1^^1  111111111    1       1   1
1^^1   s s s s     1LLLLLLL1LLL1
1^^1               1111111111111
1^^1                s s s s s s1
1^^1                           1
1^^1           ^^              1
1^^11111  11111^^              1
1^^ s s   1 s  ^^              1
1^^       1    ^^              1
1^^       1    ^^              1
1^^       1^^  ^^              1
1111   1111^^11111             1
1  1 s 1  1^^ s s              1
1  1   1  1^^          111111111
1111   1111^^           s s ^^^1
1         1^^               ^^^1
1         1^^               ^^^1
1         1^^1111      11111^^^1
1         1^^1 s        s s ^^^1
1         1^^1              ^^^1
1         1^^1              ^^^1
1         1^^1              ^^^1
1         1^^1              ^^^1
1     11111^^1111111111111111111
1     1   1^^1                 1
1     1   1^^1                 1
1     1    ^^                  1
1111  1    ^^     11111111111111
   1       ^^     1            1
   1     111111   1            1
   1LLLLL1    1LLL1LLLLLLLLLLLL1
   1LLLLL1    1LLL1LLLLLLLLLLLL1
   1LLLLL1    1LLL1LLLLLLLLLLLL1
   1111111    111111111111111111
