MEGADOOM
JIISUKI
DM9.bmp
2
0
32
32
                                
                                
                                
11111111   1111111              
10000001   0000001              
1000aag1 s 0000001              
101111111111111001              
100000010000000001              
111111010000000001              
1^0000010000000001              
1^111111111111110111111111111111
1^000001Z 0000000000000000000001
1^000001110000000000000000000001
1^000001000000000000000000000001
1^000001111111111100000000000001
1^000000100000000000000000000001
1^000000100000000000100100100001
1^000000100000000000000000000001
1^000000000000000000000000000001
1^001111111111000000000000000001
1^001        1000000100100100001
1^001   jd   1000000000000000001
1^001  1111  1000000000000000001
1^000  Z11Z  0000000000000000001
1^011111111111111111111111110011
1^000000000000000000000000000001
1^000000000000000000000000000001
1^000000000111111110000000000001
111111110001      10000000000001
111111111000     l00000000001J11
111111111100     110000000001111
111111111111      11111111111111
